*********
*    S* *
* * *** *
* * *   *
* * *** *
* * *   *
* * * * *
*     * *
*******X*
