***********************************************************************
*                                         *                           *
*                                         *                           *
*                                         *                           *
*                                         ********* ******* * * *** * *
*              S                          *     * *     *   * *     * *
*                                         * *** * ***** * *** ******* *
*                                         *   * *     *   *         * *
********* ***** ******* * ***** * *** * ***** * *** ******* *** *** * *
*                                                                     *
*                                         *                           *
* * *     * *   *   *       * * * * *     *     *     * *     *   *   *
* * * ***** *** *** * ******* * * * ***** * ***** ***** * ********* ***
* * *     * *       * *   *   *   * *     * *       *   * *   *     * *
*** ***** * ********* * * *** * *** ***** * * ******* *** * * * ***** *
*       * *     *   *   *   *   *   *   * * * *       *   * *   *   * *
* ******* ***** * * * ***** ***** *** * * * *** * ********* ***** * * *
*       *   *   * *   *   *     * *   * * *   * * *   *   *   *   *   *
* ***** *** * *** ***** * ***** * *** * ***** * *** * * * *** *** *** *
*     *       *         *     *       *   *   *     *   *         *   *
*********************************************************************X*
