*X*******
*     * *
* ***** *
* * *   *
* * *** *
*   *   *
*** * * *
*S    * *
*******X*
