***********************************************************************
*                   *   *                   *   *               *     *
* * * * * * * ***** * * ********* ********* * * ***** ********* * *** *
*                 *   *   *     *   *     *   *     *       * * *   * *
* * * * * * * *** ******* * *** *** * *** ********* ******* * * *** * *
*              S*   *     *   *   * *   * *     * *     *   * *     * *
* * * * * * * ***** * ******* *** * * *** * *** * ***** * *** ******* *
*             *     *   *     * * *   *   *   * *     *   *         * *
********* ***** ******* * ***** * *** * ***** * *** ******* *** *** * *
*       * *   *   *   *   *     *   * *       * *   *     * *   *   * *
* * ***** * * *** *** ***** *** *** * ********* * *** * * *** *** *** *
* * *     * *   *   *       * * * * *     *     *     * *     *   *   *
* * * ***** *** *** * ******* * * * ***** * ***** ***** * ********* ***
* * *     * *       * *   *   *   * *     * *       *   * *   *     * *
*** ***** * ********* * * *** * *** ***** * * ******* *** * * * ***** *
*       * *     *   *   *   *   *   *   * * * *       *   * *   *   * *
* ******* ***** * * * ***** ***** *** * * * *** * ********* ***** * * *
*       *   *   * *   *   *     * *   * * *   * * *   *   *   *   *   *
* ***** *** * *** ***** * ***** * *** * ***** * *** * * * *** *** *** *
*     *       *         *     *       *       *     *   *         *   *
*********************************************************************X*
