***********************************************************************
*   *               *   *                   *   *               *     *
* * * ***** ******* * * ********* ********* * * ***** ********* * *** *
* * * *     *     *   *   *     *   *     *   *     *       * * *   * *
* * * * ***** *** ******* * *** *** * *** ********* ******* * * *** * *
*   * *         *   *     *   *   * *   * *     * *     *   * *     * *
* ********* ******* * ******* *** * * *** * *** * ***** * *** ******* *
*         *   *     *   *     * * *   *   *   * *     *   *         * *
********* ***** ******* * ***** * *** * ***** * *** ******* *** *** * *
*       * *   *   *   *   *     *   * *       * *   *     * *   *   * *
* * ***** * * *** *** ***** *** *** * ********* * *** * * *** *** *** *
* * *     * *   *   *       * * * * *     *     *     * *     *   *   *
* * * ***** *** *** * ******* * * * ***** * ***** ***** * ********* ***
*S* *     * *       * *   *   *   * *     * *       *   * *   *     * *
*** ***** * ********* * * *** * *** ***** * * ******* *** * * * ***** *
*       * *     *   *   *   *   *   *   * * * *       *   * *   *   * *
* ******* ***** * * * ***** ***** *** * * * *** * ********* ***** * * *
*       *   *   * *   *   *     * *   * * *   * * *   *   *   *   *   *
* ***** *** * *** ***** * ***** * *** * ***** * *** * * * *** *** *** *
*     *       *         *     *       *       *     *   *         *   *
*********************************************************************X*
